#########################################
#        ##     #     ######            #
#   1           #          #            #
#        #           #    #             # 
#    #    ######      #    #            #
#    #    #          ##                 #
#    #    #    ## #####    #            # 
#                        #              #
#    #    #    #     #    #             #
#    #    ######         #              #
#         #          #     #            #
#    #    #               #             #
#    ######          ### ###       2    #
#                                       #
#########################################
