########################################
#                                      #
#   1             ##                   #
#                 ##                   #
#                                      #
#           ##                         #
#           ##                         #
#                                      #
#                    ##                #
#                    ##                #
#                                      #
#                           ##         #
#           ##                       2 #
#                                      #
########################################
