########################################
#    ######     #     ######          #
#   1#    #     #     #    #         #
#    #    #     #     #    #         #
#    #    ######      #    #         #
#    #    #          ##    #         #
#    #    #    ########    #         #
#    ######    #     #######         #
#    #    #    #     #    #         #
#    #    ######     #    #         #
#    #    #          #    #       2 #
#    #    #          #    #         #
#    ######          ######          #
#                                    #
########################################
