########################################
#    #          #           #         #
#   1#          #           #         #
#    #          #           #         #
#    #          #           #         #
#    #          #           #         #
#    #          #           #         #
#    ############           #         #
#    #          #           #         #
#    #          #           #         #
#    #          #           #       2 #
#    #          #           #         #
#               #                     #
#                                    #
########################################
