########################################
#    ##         ##           ##        #
#   1           ##                     #
#    ##         ##           ##        #
#    ##                      ##        #
#               ##           ##        #
#    ######   #######  ## #######      #
#               ##                     #
#    ##         ##                     #
#    ##         ##          ##         #
#                                   2  #
#    ##         ##          ##         #
#    ##         ##          ##         #
#                                      #
########################################
