########################################
#                                      #
#   1                                  #
#                                      #
#                                      #
#                                      #
#                                      #
#                                      #
#                                      #
#                                      #
#                                      #
#                                      #
#                                    2 #
#                                      #
########################################
