########################################
#                                      #
#             ################         #
#                      2               #
#                                      #
#         ##                  ##       #
#         ##                  ##       #
#                  ##                  #
#         ##                  ##       #
#         ##                  ##       #
#                                      #
#             #################        #
#            1                         #
#                                      #
########################################
