########################################
#                                      #
#   1         ################         #
#                                      #
#                                      #
#         ##                  ##       #
#         ##                  ##       #
#                                      #
#         ##                  ##       #
#         ##                  ##       #
#                                      #
#             ################       2 #
#                                      #
#                                      #
########################################
