########################################
#    ##         ##          ##        #
#   1##         ##          ##        #
#    ##         ##          ##        #
#    ##         ##          ##        #
#               ##          ##        #
#    ###########################      #
#               ##          ##        #
#    ##         ##          ##        #
#    ##         ##          ##        #
#    ##         ##          ##      2 #
#    ##         ##          ##        #
#    ##         ##          ##        #
#                                     #
########################################
