########################################
#             #                        #
#              #           #           #
#                                      #
#              #           #           #
#              #           #           #
#                                      #
#   ###### ######  #########           #
#              #           #           #
#              #           #           #
#              #           #           #
#              #                    2  #
#    1         #                       #
#                                      #
########################################
