########################################
#    #####      #      #####          #
#   1#          #           #         #
#    #          #           #         #
#    #          #           #         #
#    #     ######           #         #
#    #          #           #         #
#    #          #     ######          #
#    #          #           #         #
#    #     ######           #         #
#    #          #           #       2 #
#    #          #           #         #
#    #####      #      #####          #
#                                     #
########################################
