########################################
#                                      #
#   1             ##                   #
#                 ##                   #
#                                      #
#           ##                         #
#           ##                         #
#                                      #
#                    ##               #
#                    ##               #
#                                      #
#                           ##         #
#                           ##       2 #
#                                      #
########################################
