########################################
#    ######     #    ######           #
#   1#          #         #           #
#    #          #         #           #
#    #     ######         #           #
#    #          #         #           #
#    #          #    ######           #
#    ######     #         #           #
#    #          #         #           #
#    #     ######         #           #
#    #          #         #         2 #
#    #          #         #           #
#    ######     #    ######           #
#                                     #
########################################
