########################################
#              ##                      #
#         ##                      2    #
#              ##                      #
#          ##         ##               #
#              ##    ##                #
#                        ##            #
#      1                       ##      #
#           ##          ##             #
#           ##          ##             #
#           ##                         #
#           ##                         #
#           ##                         #
#                                      #
########################################
