########################################
#              #                       #
#   1          #           #          #
#              #           #          #
#              #           #          #
#              #           #          #
#                         #           #
#   ########################          #
#              #           #          #
#              #           #          #
#              #           #          #
#              #                    2 #
#              #                      #
#                                    #
########################################
