########################################
#    #          #           #          #
#   1           #           #          #
#               #           #          #
#    #                      #          #
#    #          #           #          #
#    #          #           #          #
#    #####  #####                      #
#    #          #     #     #          #
#    #          #     #     #          #
#    #                             2   #
#    #          #           #          #
#               #                      #
#                                      #
########################################
