########################################
#    ######     #    ### ###           #
#   1           #                      #
#    #          #           #          #
#    #     ######         #      #     #
#    #                #                #
#    ######          ######            #
#               #                      #
#    #          #         #            #
#          ######         #            #
#    #          #                   2  #
#    #          #         #            #
#    ######     #    ######            #
#                                      #
########################################
