########################################
#    #  ##      #      #  # #          #
#   1           #         #            #
#    #                      #          #
#    #          #                      #
#    #     ######           #          #
#               #           #          #
#    #                ######           #
#    #          #           #          #
#    #     ######                      #
#    #          #           #       2  #
#                           #          #
#    #####      #      #####           #
#                                      #
########################################
