########################################
#              ##                      #
#   1          ##                     #
#              ##                     #
#              ##         ##          #
#              ##         ##          #
#                        ##           #
#                        ##           #
#           ##          ##            #
#           ##          ##            #
#           ##                        #
#           ##                      2 #
#           ##                        #
#                                     #
########################################
